XXXXXXXXXXXXXXXXXXXXXXXXXXXXXXXXXXXXXXXXXXXXXXXXXXXXXXXXXXXXXXXXXXXXXXXXXXXX
X000000000000000000XX00000000000000XX00000000000000000000000000XX0000000000X
X000000000000000000XX00000000000000XX00000000000000000000000000XX00000$0000X
X0000000$0000000000XX00000000000000XX00000000000000000000000000XX0000000000X
X000000000000000000XX00000000000000XX00000000000000000$00000000XX000XXXX000X
X000000000000000000XX00000000000000XX00000000000000000000000000XX000XXXX000X
X000000000000000000XX00000000000000XX00000000000000000000000000XX0000XX0000X
XXXXXXXXXXXXXX00XXXXXXXXXXXXXX00XXXXXXXXXXXXXXXXXXXXXXX00000000XX0000XX0000X
XXXXXXXXXXXXXX00XXXXXXXXXXXXXX00XXXXXXXXXXXXXXXXXXXXXXX00000000XX0000XX0000X
X000000XX00000000000000000000000000XX0000000000000000XX00000000XX0000XX0000X
X000000XX00000000000000000000000000XX00000000000000000000000000XX0000000000X
X000000XX00000000000000000000000000XX00000000000000000000000000XX0000000000X
X0000000000000000000000000000000000XX0000000000000000XX00000000XX00XX000$00X
X0000000000000000000000000000000000XX0000000000000000XX00000000XX00XX000000X
X000000XX00000000000000000000000000XX0000000000000000XX00000000XX00XXXX0000X
X000000XX00000000000000000000000000XX000000XX00000000XX0000$000XX00XXXX0000X
X000000XX00000000000000000000000000XX000000XX00000000XX00000000XX0000XX0000X
X000000XX00000000000000000000000000XX0000000000000000XX00000000XX0000XX0000X
X000000XX00000000$00000000000000000XX00000000000$0000XX00000000000000000000X
XXXXXXXXX00000000000000000000000000XX0000000000000000XX00000000000000000000X
XXXXXXXXX00000000000000000000000000XX0000000000000000XX00000000XXXXXX000000X
X00000000000000000000000$0000000000XX0000000000000000XX000$0000XXXXXX000000X
X0000000000000000000000000000000000XX0000000000000000XX00000000XX0000000000X
X000000XX00000000000000000000000000XX0000000000000000XX00000000XXXXXXXXXXXXX
X000000XX00000000000000000000000000XX0000000000000000XX00000000XXXXXXXXXXXXX
X000000XX00000000000000000000000000XX0000000000000000XX00000000XX0000000000X
X000000XX00000000000000000000000000XX0000000000000000XX00000000XX0000000000X
XXXXXXXXXXXXXXXXXXXXXXXXXXXX0000XXXXX000000XX00000000XX00000000000000000000X
XXXXXXXXXXXXXXXXXXXXXXXXXXXX0000XXXXX000000XX00000000XX00000$00000000000000X
XXXXXXXXXXXXXXXXXXXX000000000000000XX0000000000000000XX00000000XX0000000000X
XXXXXXXXXXXXXXXXXXXX000000000000000XX0000000000000000XX00000000XX0000000000X
XXXXX0000XXXXXXXXXXX000000000000000XX0000000000000000XX00000000XX0000000000X
XXXXX0000XXXXXXXXXXX000000000000000XX00000000000000000000000000XX00000$0000X
XXXXX0000XXXXXXXXXXX000000000000000XX00000000000000000000000000XX0000000000X
XXXXX0000XXXXXXXXXXX000000000000000XX0000000000000000XX00000000XX0000000000X
XXXXXXX00XXXXXXXXXXX000000000000000XXXXXXXXXXXXXXXXXXXX00000000XXXXXXXXXXXXX
XXXXXXX00XXXXXXXXXXX000000000000000XXXXXXXXXXXXXXXXXXXX00000000XXXXXXXXXXXXX
X0000XX000000000000000000000000000000000000XXXX0000XX0000000000000000000000X
X000000000000000000000000000000000000000000XXXX0000XX0000000000000000000000X
X000000000000000000000000000000000000000000XXXX0000XX0000000000000000000000X
X0000XX000000000000000000000000000000000000XXXX0000XX000000000$000000000000X
XXXXXXX00000000000000000$0000000000XX00000000000000000000000000000000000000X
XXXXXXX0000000000000000000000000000XX00000000000000000000000000000000000000X
X0000000000000000000000000000000000XX00000000XXXXXX00XXXXX00XXX000000000000X
X0000000000000000000000000000000000XX00000000X00000000X0000000X000000000000X
X0000000000000000000000000000000000XX00000000X00000000X0000000X000000000000X
X0000000000000000000000000000000000XX00000000X00000000X0000000X000000000000X
X000000000000000000000000000XXXXXXXXX00000000X00000000X0000000X000000000000X
XXX00000000000$0000000000000XXXXXXXXX00000000X00000000X0000000X000000000000X
XXX0000000000000000000000000XXXXXXXXX00000000X00000000X0000000X000000000000X
XXX0000000000000000000000000XXXXXXXXX00000000X00000000X0000000X000000$00000X
XXX00000000000000000XXXXXXXXXXXXXXXXX00000000XXXXXXXXXXXXXXXXXX000000000000X
XXX00000000000000000XXXXXXXXXXXXXXXXX0000000000000000000000000X000000000000X
XXX00000000000000000XXXXXXXXXXXXXXXXX0000000000000000000000000X000000000000X
XXX00000000000000000XXXXXXXXXXXXXXXXX00000000X0000000000000000X000000000000X
XXXXXXXXXXXXXXXX0000XXXXXXXXXXXXXXXXX00000000X0000000000000000X000000000000X
XXXXXXXXXXXXXXXX0000XXXXXXXXXXXXXXXXX0000$000X0000000000000000X000000000000X
X0000000000000000000XXXXXXXXXXXXXXXXX00000000X0000000000000000X000000000000X
X0000000000000000000XXXXXXXXXXXXXXXXX00000000X0000000000000000X000000000000X
X0000000000000000000XXXXXXXXXXXXXXXXX00000000XXXXXXXXXXXXXXXXXX000000000000X
X0000000000000000000XXXXXXXXXXXXXXXXX0000000000000000000000000X000000000000X
X0000000000000000000XXXXXXXXXXXXXXXXX0000000000000000000000000X000000000000X
X0000000000000000000XXXXXXXXXXXXXXXXX00000000X0000000000000000X000000000000X
X0000000000000000000XXXXXXXXXXXXXXXXX00000000X000000000$000000X000000000000X
X0000000000000000000XXXXXXXXXXXXXXXXX00000000X0000000000000000X000000$00000X
X0000000000000000000XXXXXXXXXXXXXXXXX00000000X0000000000000000X000000000000X
X00$$000000000000000XXXXXXXXXXXXXXXXX00000000X0000000000000000X000000000000X
X00$$000000000000000XXXXXXXXXXXXXXXXXXXXX0000XXXXXXXXXXXXXXXXXX000000000000X
X0000000000000000000XXXXXXXXXXXXXXXXX0000000000000000000000000X000000000000X
X0000000000000000000XXXXXXXXXXXXXXXXX0000000000000000000000000X000000000000X
X0000000000000000000XXXXXXXXXXXXXXXXX0000000000000000000000000X000000000000X
X0000000000$00000000XXXXXXXXXXXXXXXXX00000000000000000000XXXXXX000000000000X
X0000000000000000000XXXXXXXXXXXXXXXXXXXXX0000000000000000X0000000000$000000X
X0000000000000000000000000000000000XX00000000000000000000X00000000000000000X
X000000000000000000000000000000000000000000000000$0000000X00000000000000000X
X00000000000000000000000000000000000000000000000000000000X00000000000000000X
XXXXXXXXXXXXXXXXXXXXXXXXXXXXXXXXXXXXXXXXXXXXXXXXXXXXXXXXXXXXXXXXXXXXXXXXXXXX
